24
9
BB BG GG BB BB BC CB RB RR RR RR RR RR RR RR RR BR BB BB BB BB BB BB BB
BB GG GB BB BB BC CB BR RR RR RR BB BB RR RR RR RB BB BB BB BB BB BB BB
BB YY YY YY YY YY BB CM BB RY YY YY YY YY RR YY YY YY YY YY YY YY YY BB
BB YY YY YY YY YY BB CC BB YR YY YY YY YY RR YY YY YY YY YY YY YY YY BB
BB YY YY YY BB BC CB BB RB RR RR BB BB RR RR BR BB BB BB BB YY YY YY BB
BB YY YY YY BB BC CB BB BR RR RR BB BB RR RR RB BB BB BB BB YY YY YY BB
BB YY YY YY BB YY YY YY BB RR YY YY YY YY RR YY YY YY YY BB YY YY YY BB
BB YY YY YY BB YY YY YY YY RR YY YY YY YY RR YY YY YY YY BB YY YY YY BB
BB GG GG YY YB YC CY GM YY RY YY YY YY YY YR YY YY YY YY BY MM YY YY BB
BB GG GG YY BY YC CY GG YY YR YY YY YY YY RY YY YY YY YY YB MM YY YY BB
BB YY YY YY BB YY YY YY YY RR YY YY YY YY RR YY YY YY YY BB YY YY YY BB
BB YY YY YY BB YY YY YY BB RR YY YY YY YY RR YY YY YY YY BB YY YY YY BB
BB YY YY YY BB BC CB BB BR RR RR BB BB RR RR RB BB BB BB BB YY YY YY BB
BB YY YY YY BB BC CB BB RB RR RR BB BB RR RR BR BB BB BB BB YY YY YY BB
BB YY YY YY YY YY YY YY YY RR YY YY YY YY RR YY YY YY YY YY YY YY YY BB
BB YY YY YY YY YY YY YY YY RR YY YY YY YY RR YY YY YY YY YY YY YY YY BB
BB BB BB BB BB BC CB BR RR RR RR BB BB RR RR RR RB BB BB BB MM MM MB BB
BB BB BB BB BB BC CB RB RR RR RR RR RR RR RR RR BR BB BB BB MM BM MM BB